1,1,1,1,1,2,3,4,1,1,1,1,1,2,3,3,3,3,3,5,6,7,8,
9,10,11,11,11,12,1,13,9,10,11,11,11,12,1,1,1,14,15,16,17,18,19,
20,21,22,22,22,22,22,22,20,21,22,22,22,22,22,22,22,20,23,24,25,26,27,
28,23,29,29,23,29,23,29,28,23,29,29,23,29,23,23,23,28,30,31,32,33,34,
35,36,37,38,39,37,39,37,35,36,37,38,39,37,39,40,41,42,43,44,45,46,47